####
#  ###
#  $ #
#  $.##
#   *+#
#######