########
#  .   #
#      #
#  $   #
#  @   #
#      #
########