########
#  #   #
#$$$$ .#
#   @ .#
#     .#
#     .#
########