#######
#    .#
#  $$ #
##. @##
 #####
