########
#      #
#$$$$ .#
#    @.#
#     .#
#     .#
########