###########
#        .#
#    $    #
#@        #
###########