  ######
  #    #
  # $  #
### @  #
#.  *  #
########